id,day_hour,clientip,GET,POST,HEAD,hour,no_of_client
1,2019-01-28 9,54.36.149.47,0,1,0,9,1
2,2019-01-31 16,31.56.96.64,0,2,0,16,2
3,2019-01-22 3,40.77.167.129,7995,1000,0,3,8995
4,2019-01-31 13,54.36.149.51,0,1,0,13,1
5,2019-01-27 8,31.56.96.56,0,2,0,8,2
6,2019-01-22 3,207.46.13.104,4992,998,0,3,5990
7,2019-01-30 11,66.249.66.202,0,2,0,11,2
8,2019-01-31 16,91.99.72.28,0,1,0,16,1
9,2019-01-30 11,31.56.96.59,0,4,0,11,4
10,2019-01-22 3,172.20.2.174,998,0,0,3,998
11,2019-01-22 4,2.179.141.99,0,999,0,4,999
12,2019-01-25 6,40.77.167.132,0,5,0,6,5
13,2019-01-27 8,91.99.72.20,0,1,0,8,1
14,2019-01-22 3,204.18.198.248,7989,996,0,3,8985
15,2019-01-31 14,40.77.167.140,0,5,0,14,5
16,2019-01-31 23,31.56.96.72,0,8,0,23,8
17,2019-01-22 4,54.36.148.18,999,0,0,4,999
18,2019-01-31 15,54.36.149.53,0,2,0,15,2
19,2019-01-22 3,104.194.24.33,997,0,0,3,997
20,2019-01-31 16,54.36.149.54,0,1,0,16,1
21,2019-01-22 5,31.56.96.52,1,0,0,5,1
22,2019-01-22 4,5.209.200.219,1998,0,0,4,1998
23,2019-01-26 7,66.249.66.198,0,1,0,7,1
24,2019-01-31 23,54.36.149.62,0,4,0,23,4
25,2019-01-31 23,40.77.167.150,0,20,0,23,20
26,2019-01-24 5,54.36.149.43,0,1,0,5,1
27,2019-01-31 20,91.99.72.32,0,3,0,20,3
28,2019-01-22 3,54.36.148.32,999,0,0,3,999
29,2019-01-31 15,66.249.66.206,0,2,0,15,2
30,2019-01-22 3,207.46.13.136,8990,999,0,3,9989
31,2019-01-30 11,40.77.167.137,0,10,0,11,10
32,2019-01-31 21,40.77.167.147,0,15,0,21,15
33,2019-01-22 4,66.111.54.250,2997,0,0,4,2997
34,2019-01-26 7,91.99.72.19,0,1,0,7,1
35,2019-01-22 3,173.249.54.67,5994,0,0,3,5994
36,2019-01-22 3,46.224.77.32,3990,0,0,3,3990
37,2019-01-31 14,54.36.149.52,0,1,0,14,1
38,2019-01-31 15,91.99.72.27,0,2,0,15,2
39,2019-01-28 9,31.56.96.57,0,2,0,9,2
40,2019-01-31 23,66.249.66.215,0,4,0,23,4
41,2019-01-24 5,91.99.72.17,0,1,0,5,1
42,2019-01-31 20,54.36.149.58,0,3,0,20,3
43,"",n/2019:03:57:04,1,0,0,"",1
44,2019-01-22 4,40.77.167.130,1000,0,0,4,1000
45,2019-01-22 3,54.36.149.63,999,0,0,3,999
46,2019-01-22 3,5.78.198.52,4996,8992,0,3,13988
47,2019-01-22 3,5.209.200.218,16977,1998,0,3,18975
48,2019-01-22 3,54.36.148.161,0,999,0,3,999
49,2019-01-31 20,66.249.66.211,0,3,0,20,3
50,2019-01-30 11,91.99.72.23,0,2,0,11,2
51,2019-01-31 14,31.56.96.62,0,2,0,14,2
52,2019-01-22 3,66.249.66.91,15976,1000,0,3,16976
53,2019-01-31 13,40.77.167.139,0,5,0,13,5
54,2019-01-31 18,31.56.96.66,0,2,0,18,2
55,2019-01-28 9,40.77.167.135,0,5,0,9,5
56,2019-01-22 4,66.249.66.195,4993,997,0,4,5990
57,2019-01-28 9,66.249.66.200,0,1,0,9,1
58,2019-01-31 15,40.77.167.141,0,10,0,15,10
59,2019-01-22 4,31.56.96.52,998,0,0,4,998
60,2019-01-31 18,40.77.167.144,0,5,0,18,5
61,2019-01-25 6,66.249.66.197,0,1,0,6,1
62,2019-01-22 3,.249.66.194,1,0,0,3,1
63,2019-01-22 3,89.199.193.251,999,0,0,3,999
64,2019-01-31 19,66.249.66.210,0,1,0,19,1
65,2019-01-31 21,54.36.149.59,0,3,0,21,3
66,2019-01-31 12,91.99.72.24,0,1,0,12,1
67,2019-01-31 12,31.56.96.60,0,2,0,12,2
68,2019-01-31 19,31.56.96.67,0,2,0,19,2
69,2019-01-31 22,91.99.72.34,0,3,0,22,3
70,2019-01-22 3,54.36.148.117,997,0,0,3,997
71,2019-01-22 4,54.36.148.11,999,0,0,4,999
72,2019-01-31 19,91.99.72.31,0,1,0,19,1
73,2019-01-22 4,5.62.206.250,999,0,0,4,999
74,2019-01-22 3,5.78.180.75,999,0,0,3,999
75,2019-01-22 3,51.15.15.54,1998,0,0,3,1998
76,2019-01-22 3,2.185.221.79,999,0,0,3,999
77,2019-01-31 21,66.249.66.212,0,3,0,21,3
78,2019-01-29 10,66.249.66.201,0,1,0,10,1
79,2019-01-22 3,54.36.149.92,996,0,0,3,996
80,2019-01-22 4,91.99.72.16,1999,999,0,4,2998
81,2019-01-22 4,66.249.66.92,2996,0,0,4,2996
82,2019-01-22 3,66.249.64.66,999,0,0,3,999
83,2019-01-31 21,31.56.96.69,0,6,0,21,6
84,2019-01-22 3,17.58.102.43,2997,0,0,3,2997
85,2019-01-22 4,204.18.198.249,997,0,0,4,997
86,2019-01-22 3,207.46.13.115,4995,1998,0,3,6993
87,2019-01-31 12,54.36.149.50,0,1,0,12,1
88,2019-01-22 3,5.211.97.39,24961,4993,3996,3,33950
89,2019-01-31 22,31.56.96.70,0,6,0,22,6
90,2019-01-26 7,31.56.96.55,0,2,0,7,2
91,2019-01-27 8,40.77.167.134,0,5,0,8,5
92,2019-01-24 5,66.249.66.196,0,1,0,5,1
93,2019-01-31 22,54.36.149.60,0,3,0,22,3
94,2019-01-22 3,91.99.72.15,11986,997,0,3,12983
95,2019-01-22 4,207.46.13.137,999,0,0,4,999
96,2019-01-27 8,66.249.66.199,0,1,0,8,1
97,2019-01-24 5,31.56.96.53,0,2,0,5,2
98,2019-01-26 7,40.77.167.133,0,5,0,7,5
99,2019-01-22 3,54.36.148.18,999,0,0,3,999
100,2019-01-31 13,31.56.96.61,0,2,0,13,2
101,2019-01-28 9,91.99.72.21,0,1,0,9,1
102,2019-01-22 3,178.253.33.51,6000,0,0,3,6000
103,2019-01-22 4,5.78.198.53,998,999,0,4,1997
104,2019-01-22 3,54.36.149.70,1000,0,0,3,1000
105,2019-01-22 3,5.160.157.20,1995,0,0,3,1995
106,2019-01-31 15,31.56.96.63,0,4,0,15,4
107,2019-01-22 3,2.177.12.140,12997,2999,0,3,15996
108,2019-01-22 3,2.179.141.98,2997,1998,0,3,4995
109,2019-01-25 6,31.56.96.54,0,2,0,6,2
110,2019-01-30 11,31.56.96.51,0,1,0,11,1
111,2019-01-31 13,66.249.66.204,0,1,0,13,1
112,2019-01-31 17,91.99.72.29,0,1,0,17,1
113,2019-01-31 19,40.77.167.145,0,5,0,19,5
114,2019-01-31 18,91.99.72.30,0,1,0,18,1
115,2019-01-31 20,40.77.167.146,0,15,0,20,15
116,2019-01-27 8,54.36.149.46,0,1,0,8,1
117,2019-01-22 3,54.36.149.17,0,999,0,3,999
118,2019-01-31 14,91.99.72.26,0,1,0,14,1
119,2019-01-31 13,91.99.72.25,0,1,0,13,1
120,2019-01-22 3,34.247.132.53,1000,0,0,3,1000
121,2019-01-31 21,91.99.72.33,0,3,0,21,3
122,2019-01-22 3,54.36.148.87,999,0,0,3,999
123,2019-01-31 17,54.36.149.55,0,1,0,17,1
124,2019-01-22 3,5.112.52.254,1998,0,0,3,1998
125,2019-01-31 14,66.249.66.205,0,1,0,14,1
126,2019-01-31 23,91.99.72.36,0,4,0,23,4
127,2019-01-22 3,54.36.148.232,998,0,0,3,998
128,2019-01-22 3,157.55.39.245,1998,999,0,3,2997
129,2019-01-29 10,54.36.149.48,0,1,0,10,1
130,2019-01-22 3,54.36.149.35,999,0,0,3,999
131,2019-01-26 7,54.36.149.45,0,1,0,7,1
132,2019-01-31 18,54.36.149.56,0,1,0,18,1
133,2019-01-22 4,5.211.97.40,1998,0,0,4,1998
134,2019-01-31 12,40.77.167.138,0,5,0,12,5
135,2019-01-31 17,31.56.96.65,0,2,0,17,2
136,2019-01-22 4,2.177.12.141,1999,0,0,4,1999
137,2019-01-22 3,54.36.149.58,0,999,0,3,999
138,2019-01-31 12,66.249.66.203,0,1,0,12,1
139,2019-01-25 6,91.99.72.18,0,1,0,6,1
140,2019-01-22 3,66.111.54.249,31960,2996,0,3,34956
141,2019-01-25 6,54.36.149.44,0,1,0,6,1
142,2019-01-31 16,40.77.167.142,0,5,0,16,5
143,2019-01-22 3,54.36.149.41,999,0,0,3,999
144,2019-01-29 10,91.99.72.22,0,1,0,10,1
145,2019-01-31 22,66.249.66.213,0,3,0,22,3
146,2019-01-24 5,40.77.167.131,0,5,0,5,5
147,2019-01-22 3,66.249.66.194,21970,2997,0,3,24967
148,2019-01-31 22,40.77.167.148,0,15,0,22,15
149,2019-01-29 10,31.56.96.58,0,2,0,10,2
150,2019-01-30 11,54.36.149.49,0,1,0,11,1
151,2019-01-31 17,66.249.66.208,0,1,0,17,1
152,2019-01-29 10,40.77.167.136,0,5,0,10,5
153,2019-01-31 16,66.249.66.207,0,1,0,16,1
154,2019-01-31 17,40.77.167.143,0,5,0,17,5
155,2019-01-31 18,66.249.66.209,0,1,0,18,1
156,2019-01-31 19,54.36.149.57,0,1,0,19,1
157,2019-01-22 3,31.56.96.51,19977,999,0,3,20976
158,2019-01-31 20,31.56.96.68,0,6,0,20,6
